"Date","Status","Type","CheckNumber","Description","Withdrawal","Deposit","RunningBalance"
"12/03/2023","Posted","VISA","","Spotify","$5.46","","$338.40"
"12/02/2023","Posted","VISA","","Netflix","$20.00","","$343.86"
"12/01/2023","Posted","VISA","","DIGITALOCEAN.COM DIGITALOCEAN.","$12.00","","$363.86"
"11/30/2023","Posted","INTADJUST","","Interest Paid","","$2.15","$375.86"
"11/29/2023","Posted","ACH","","AMAZON.COM, INC. PAYMENTS 123123~ Tran:","","$12.03","$375.71"
"11/22/2023","Posted","VISA","","CHATGPT SUBSCRIPTION HTTPSOPENAI.C","$20.00","","$363.68"
"11/18/2023","Posted","VISA","","Google YouTubePremium 999-54545454","$26.02","","$383.68"
"11/17/2023","Posted","VISA","","BOARD COASTLINE COMPANY","$9.00","","$409.70"
"11/12/2023","Posted","VISA","","PWP*OPENAI 555-112233","$0.61","","$418.70"
